The grade equivalent of 0 is :	F
The grade equivalent of 1 is :	F
The grade equivalent of 2 is :	F
The grade equivalent of 3 is :	F
The grade equivalent of 4 is :	F
The grade equivalent of 5 is :	F
The grade equivalent of 6 is :	F
The grade equivalent of 7 is :	F
The grade equivalent of 8 is :	F
The grade equivalent of 9 is :	F
The grade equivalent of 10 is :	F
The grade equivalent of 11 is :	F
The grade equivalent of 12 is :	F
The grade equivalent of 13 is :	F
The grade equivalent of 14 is :	F
The grade equivalent of 15 is :	F
The grade equivalent of 16 is :	F
The grade equivalent of 17 is :	F
The grade equivalent of 18 is :	F
The grade equivalent of 19 is :	F
The grade equivalent of 20 is :	F
The grade equivalent of 21 is :	F
The grade equivalent of 22 is :	F
The grade equivalent of 23 is :	F
The grade equivalent of 24 is :	F
The grade equivalent of 25 is :	F
The grade equivalent of 26 is :	F
The grade equivalent of 27 is :	F
The grade equivalent of 28 is :	F
The grade equivalent of 29 is :	F
The grade equivalent of 30 is :	F
The grade equivalent of 31 is :	F
The grade equivalent of 32 is :	F
The grade equivalent of 33 is :	F
The grade equivalent of 34 is :	F
The grade equivalent of 35 is :	F
The grade equivalent of 36 is :	F
The grade equivalent of 37 is :	F
The grade equivalent of 38 is :	F
The grade equivalent of 39 is :	F
The grade equivalent of 40 is :	F
The grade equivalent of 41 is :	F
The grade equivalent of 42 is :	F
The grade equivalent of 43 is :	F
The grade equivalent of 44 is :	F
The grade equivalent of 45 is :	F
The grade equivalent of 46 is :	F
The grade equivalent of 47 is :	F
The grade equivalent of 48 is :	F
The grade equivalent of 49 is :	F
The grade equivalent of 50 is :	F
The grade equivalent of 51 is :	F
The grade equivalent of 52 is :	F
The grade equivalent of 53 is :	F
The grade equivalent of 54 is :	F
The grade equivalent of 55 is :	F
The grade equivalent of 56 is :	F
The grade equivalent of 57 is :	F
The grade equivalent of 58 is :	F
The grade equivalent of 59 is :	F
The grade equivalent of 60 is :	D
The grade equivalent of 61 is :	D
The grade equivalent of 62 is :	D
The grade equivalent of 63 is :	D
The grade equivalent of 64 is :	D
The grade equivalent of 65 is :	D
The grade equivalent of 66 is :	D
The grade equivalent of 67 is :	D
The grade equivalent of 68 is :	D
The grade equivalent of 69 is :	D
The grade equivalent of 70 is :	C
The grade equivalent of 71 is :	C
The grade equivalent of 72 is :	C
The grade equivalent of 73 is :	C
The grade equivalent of 74 is :	C
The grade equivalent of 75 is :	C
The grade equivalent of 76 is :	C
The grade equivalent of 77 is :	C
The grade equivalent of 78 is :	C
The grade equivalent of 79 is :	C
The grade equivalent of 80 is :	B
The grade equivalent of 81 is :	B
The grade equivalent of 82 is :	B
The grade equivalent of 83 is :	B
The grade equivalent of 84 is :	B
The grade equivalent of 85 is :	B
The grade equivalent of 86 is :	B
The grade equivalent of 87 is :	B
The grade equivalent of 88 is :	B
The grade equivalent of 89 is :	B
The grade equivalent of 90 is :	A
The grade equivalent of 91 is :	A
The grade equivalent of 92 is :	A
The grade equivalent of 93 is :	A
The grade equivalent of 94 is :	A
The grade equivalent of 95 is :	A
The grade equivalent of 96 is :	A
The grade equivalent of 97 is :	A
The grade equivalent of 98 is :	A
The grade equivalent of 99 is :	A
The grade equivalent of 100 is :	A
